SO drgjksjkpath_to_the_south_texture./
WE ./path_to_the_west_texture
S ./path_to_the_sprite_texture
EA ./path_to_the_east_texture
C 2,150,65
F 201,66,91
NO ./path_to_the_north_texture
R 10 20

1111
10N1
1001
1011
1111
