SO ./textures/south.xpm
WE ./textures/west.xpm
EA ./textures/east.xpm
S ./textures/sprite.xpm
C 0,0,100
F 46,46,46
NO ./textures/north.xpm
R 1920 1080

        1111111111111111111111111
        1000000000110000000000001      111
        1011000001110000002000001      101
        1001000000000000000000001      101
111111111011000001110000000000001      111
100000000011000001110111111111111
11110111111111011100000010001
11110111111111011101010010001
11000000110101011100000010001
10002000000000001100000010001               11111
100000000N0000001101010010001               10201
11000001110101011111011110001               11111
11110111 1110101 101111010001
11111111 1111111 111111111111



