SO ./textures/south.xpm
WE ./textures/west.xpm
S ./textures/sprite.xpm
EA ./textures/east.xpm
C 0,204,255
F 255,51,204
NO ./textures/north.xpm
R 1800 1040

111111111111111111111111
1000000000000000000000001
1000000000000000000000001
1000010000000000000100N01
1000001000000000000000001
1000000100000000000000001
1000000010000000000000001
1000000001000000000000001
1000000000100000000000001
1000000000010000000010001
100000000000000000000001
100000000000000000000101
100000000000000000000001
100000000000000000000001
100000000000000000000001
100000000000000000000001
100000000000000000000001
100000000000000000000001
100000000000000000000001
100000000000000000000001
100000000000000000000001
100000000000000000000001
100000000000000000000001
111111111111111111111111
