SO ./textures/south.xpm
WE ./textures/west.xpm
S ./textures/sprite.xpm
EA ./textures/east.xpm
C 0,204,255
F 64,64,64
NO ./textures/north.xpm
R 1400 1000

111111111111111111111111
100000000000000000000001
100000000000000000000001
100000111111111100000001
100000000000000000000001
100000000000000000000001
100000000100000010000011
100000000000000000000001
100000000000100000000001
100010000000000000000001
100000010000000000111111
100010000000N00000000001
100000000000000000000001
100010000000000000000001
100000000000000000000001
100000000000000000000001
100000000100000000000001
100000010000000000000001
100000000010001000000001
100000000000000000000001
100000000000000000000001
100000000000000000000001
100000000000000000000001
111111111111111111111111
