SO drgjksjkpath_to_the_south_texture./
WE ./path_to_the_west_texture
S ./path_to_the_sprite_texture
EA ./path_to_the_east_texture
C 0,204,255
F 255,51,204
NO ./path_to_the_north_texture
R 1400 1080

111111111111111111111111
100000000000000000000001
100000000000000000000001
1000010000000000000000S01
1000001000000000000000001
1000000100000000000000001
1000000010000000000000001
1000000001000000000000001
1000000000100000000000001
1000000000010000000010001
100000000000000000000001
100000000000000000000101
100000000000000000000001
100000000000000000000001
100000000000000000000001
100000000000000000000001
100000000000000000000001
100000000000000000000001
100000000000000000000001
100000000000000000000001
100000000000000000000001
100000000000000000000001
100000000000000000000001
111111111111111111111111
