SO ./textures/south.xpm
WE ./textures/west.xpm
S ./textures/sprite.xpm
EA ./textures/east.xpm
C 0,0,100
F 46,46,46
NO ./textures/north.xpm
R 1920 1080

111111111111111111111111
100000000000000000000001
100000111111111100000001
100000000000000002200001
100000000000000000000001
100000020000000000000011
100000000000000000200001
100000000002000000000001
100000000000000000000001
10000000000N000000111111
100020000000000000000001
100000000000000000000001
100000200000000000000001
100000000000000000000001
100000000000000000000001
100000000100000000200001
100000010000000000000001
100000000010001000000001
100000000000000000000001
100000000000000000000001
100000000000000000000001
111111111111111111111111
