SO ./textures/south.xpm
WE ./textures/west.xpm
EA ./textures/east.xpm
S ./textures/sprite.xpm
C 0,0,100
F 46,46,46
NO ./textures/north.xpm
R 1920 1080

111111111111111111111111
100000000000000000000001
100000111111111100000001
100000000000000000000001
100000222200000000000001
100000000000000000000011
100000000000200000000001
100000000000000000000001
100000000000000000000001
10000000000N000000111111
100000000000000000000001
100000000000000000000001
100000000000000000000001
100000000000200000000001
100000000000000000000001
100000000100000000000001
100000010000000000000001
100000000010021000000001
100000000000000000000001
100020000000000000000001
100000000000000000000001
111111111111111111111111
