SO drgjksjkpath_to_the_south_texture./
WE ./path_to_the_west_texture
S ./path_to_the_sprite_texture
EA ./path_to_the_east_texture
C 2,150,65
F 255,255,255
NO ./path_to_the_north_texture
R 640 480

111111111111111111111111
100000000000000000000001
100000000000000000000001
100000000000000000000001
100000000000000000000001
100000000000000000000001
100000000000000000000001
100000000000000000000001
100000000000000000000001
100000000000000000000001
100000000000000000000001
100000000000000000000001
1000000000000000000000N1
100000000000000000000001
100000000000000000000001
100000000000000000000001
100000000000000000000001
100000000000000000000001
100000000000000000000001
100000000000000000000001
100000000000000000000001
100000000000000000000001
100000000000000000000001
111111111111111111111111
