SO drgjksjkpath_to_the_south_texture./
WE ./path_to_the_west_texture
S ./path_to_the_sprite_texture
EA ./path_to_the_east_texture
C 2,150,65
F 255,255,255
NO ./path_to_the_north_texture
R 1000 2000

  1
1101
10N1
1001
1011
1111
