SO ./textures/south.xpm
WE ./textures/west.xpm
S ./textures/sprite.xpm
EA ./textures/east.xpm
C 0,0,100
F 46,46,46
NO ./textures/north.xpm
R 1920 1080

111111111111111111111111
100000000000000000000001
100000111111111100200001
100000000000000000000001
100002000000000000000001
100000000100000010000011
100000000000000000000001
100000000000100000000001
100010000000000020000001
10000001000E000000111111
100010000000000000000001
100000000000000000000001
100010000000000000000001
100000000000000000200001
100000000000000000000001
100000000100000000020001
100000010000000000000001
100000000010001000002001
100000000000000000000001
100000000022200000000001
100000000000000000000001
111111111111111111111111
