SO ./textures/south.xpm
WE ./textures/west.xpm
S ./textures/sprite.xpm
EA ./textures/east.xpm
C 0,0,100
F 46,46,46
NO ./textures/north.xpm
R 1040 1080

1111111111
1000000001
1000000001
1000000001
10000N0001
1000000001
1000000001
1000000001
1000000001
1000000001
1000000001
1000000001
1111111111
