SO ./textures/south.xpm
WE ./textures/west.xpm
S ./textures/sprite.xpm
EA ./textures/east.xpm
C 0,204,255
F 64,64,64
NO ./textures/north.xpm
R 23 23

111111111111111111111111
100000000000000000000001
100000000000000000000001
100000000000000000000001
100000000000000000000001
100000000000000000000001
100000000000000000000001
100000000000000000000001
100000000000000000000001
100000000000000000000001
100000000000000000000001
100000000000S00000000001
100000000000000000000001
100000000000000000000001
100000000000000000000001
100000000000000000000001
100000000000000000000001
100000000000000000000001
100000000000000000000001
100000000000000000000001
100000000000000000000001
100000000000000000000001
100000000000000000000001
111111111111111111111111
