
SO ./textures/south.xpm
WE ./textures/west.xpm
S ./textures/sprite.xpm
EA ./textures/east.xpm
C 0,0,100
F 46,46,46
NO ./textures/north.xpm
R 500 500

111111111111111111111111
100000000000000000000001
100000111111111100000001
100000000000000000002001
100000000000000000000001
10000000000000000000S001
100000000000000000000001
111111111111111111111111
