SO ./textures/south.xpm
WE ./textures/west.xpm
EA ./textures/east.xpm
S ./textures/sprite.xpm
C 0,0,100
F 46,46,46
NO ./textures/north.xpm
R 1920 1080
				111111111111111111111111111111111
				100000000000000000000S00000000001
				100000000000000020000220000000001
				100000000000000000000000000000001
				111111111211111111111111111111111
