SO ./textures/south.xpm
WE ./textures/west.xpm
EA ./textures/east.xpm
S ./textures/sprite.xpm
C 0,0,100
F 46,46,46
NO ./textures/north.xpm
R 1920 1080
                 1111111           11111111111
                100S0001          1000000000001  
               10000001           1000111100001
              10002001            11111  100001 
             10020001                    100001
            10000001                    100001
           10000201  1111              100001
          10020001  12001             100001
         1200000111110021111         100001
         1000000002000000001        100001
         1000020000000002001       1002001
         1111111111100001111      1000000111111
                   100001         1200000000001
                   100001         1111111110001
                   100001                 10001
                   1000011111111111111111110001
                   1000002000002000002000020001
                   1020000002000002000002000201
                   1111111111111111111111111111
