SO ./textures/south.xpm
WE ./textures/west.xpm
EA ./textures/east.xpm
S ./textures/sprite.xpm
C 0,0,100
F 46,46,46
NO ./textures/north.xpm
R 1920 1080

11111111111111
10000000000001
10000000000000111111111
11111000000000000000001
    1000000000011111111
    100000000001
    100000000001     111111
    11111111000111111100001   111   111   1   1   1  1
    11111111000000000000001   1  1  1  1  1   1   1  1
           1000000000000001111111   1111  1   1   1111
           100000N000000001   1  1  1  1  1   1   1  1
   111111111000000000000001   1111111  111111111111111
  1000000000000000000000001
  1000000000000000000000001
  1000000111111111111110011
  10000001            10001
  1000000011111111    100001
  10000000000000011111111101
   1111111111111000000000001
                11111100111
                     1001
             111     1001
            1000111111001
            1000000001111
            100011111
             111
